12 20
|------------------|
|H......---........|
|..................|
|...F........F.....|
|..................|
|......F...|..|....|
|...@......|.......|
|..........|.......|
|..................|
|F.................|
|F.................|
|------------------|

